狗的寿命有多长	猫的声音有多长	寿命有多长	猫的寿命有多长
鱼的营养	巴沙鱼	有营养吗	巴沙鱼有营养吗
是不是个词	取消是不是	取消	取消是不是个词语
像扇子形的胖些那是什么	生螃蟹烧沙子	什么螃蟹比较像	什么螃蟹外形像扇子
情操俗语古代吗	清朝	属于古代吗	清朝属于古代吗
冰淇淋的学历	起源地	冰淇淋的	冰淇淋的起源地
玻璃两侧受压能力是多少	一点二的玻璃两侧的	一点二的玻璃两侧墙呀都说啥	两边承受的压力能承受多少	一点二的玻璃两侧受压能力是多少
凤凰社是个	在哈利波特中	是怎样的组织	凤凰社是个怎么样的组织
怎么做家书	甲水	怎么做假水	怎么做假水	怎么做假水	怎么做假水	怎么做指甲的	怎么做指甲的甲水
写信的树宋雨怎么写	写信的出宋雨	祝颂语有什么？	写信的祝颂语有什么
囊萤夜读什么什么	囊萤夜读逼	比喻什么样的人	囊萤夜读比喻什么样的人
郭京飞的老婆和陆毅的老婆什么关系	电费老婆谁	电费老婆谁电费号不是	郭京飞的	郭京飞的老婆是谁
遇到动名词	鱼的透明色	动名词	鱼的动名词是什么
谁入菜瓜无处寻的上一句是什么	飞入菜花无处寻的	飞入菜瓜布出巡的上虞句是什么	飞入菜花无处寻的上一句
新生可以用来称呼女生吗	先生可以用来称呼	新生可以用来称呼女性吗	先生可以用来称呼女性吗
一天需要消耗多少卡千卡才合适	那孕妇呢	孕妇一天需要消耗多少千卡合适
见微知著的组是什么意思	他的住的意思是什么	建威支柱的主力是什么	见微知著的著是什么意思
小爱黄林镜怎么做	红领巾	怎么做	红领巾怎么做
我国第一部是气喘是传体史书是西汉著名学家谁编写的什么	纪传体史书	我国第一部	我国第一部纪传体史书是谁编写的
建卡需要身份证原件吗	产检建卡	小爱小爱	需要身份证吗	产检建卡需要身份证原件吗
修辞手法写一段话	写一段女人的话	写一段女人	写一段拟人的	写一段拟人的修辞手法
医务科怎么	怎样	一乌克兰领导怎么当	医务科的领导怎么当
自卑的卑还能	还能怎么组词	自卑的卑查什么	自卑的卑怎么组词
脸部长做完能好吗	青瓜可以护肤吗	青瓜敷脸好吗	可以去皱纹吗	青瓜敷脸可以去皱纹吗
作者的者是不是	作者的	作者	是不是多音字	作者的者是不是多音字
中国的一元等于美国的济源	我的一元等于美国的济源	等于美国多少钱	中国的一元等于美国的多少钱
黄龄鉴于于都嗯公元前多少年	秦始皇陵见于	建于多少年	秦始皇陵建于多少年
唐山最强混居是第几届	最强魂技	唐三的	唐三的最强魂技是什么
长方体的周长	长方体的	那面积怎么求	长方体的面积怎么求
黄豆什么钱什么时间	什么时间种	黄豆什么时间种
是太和殿还是泰和园	故宫简介	哪三大殿为中心	故宫以哪三大殿为中心
为什么老人老了为什头发	会变白	老人为什么头发	人老了为什头发会变白
硬币上面的花是什么花	百度一下一元硬币上面的	一元一元硬币	一元硬币上面的花是什么花
什么不吃草	牛什么不吃奶	不吃草	什么牛不吃草
茅山是什么地方	茅山有什么好玩的地方吗	从青岛坐飞机需要多久	从青岛坐飞机到茅山需要多久
十点时为什么可以吸东西	磁铁石	为什么	为什么可以吸东西	磁铁石为什么可以吸东西
中等重症病房是什么	重症病房是什么	英文名是什么	重症病房英文名是什么
内角和是怎么求的	用算式列出来	五边形的	用算式怎么求五边形的内角和
白银度像什么	白云	像什么	白云都像什么
橙汁可以加糖吗	打果汁用什么打	炸锅	橙汁怎么	怎么榨的	怎么榨橙汁
鸣皋皇帝	高皇帝	朱元璋是吗	朱元璋是高皇帝吗
稀有气体怕什么	一氧化碳	二氧化碳	是怎么组成的	二氧化碳是怎么组成的
PE的亡种形式	完整形式	平邑的完整形式	PE的完整形式
为什么雨后会	为什么雨后	天上挂着彩虹	为什么雨后天上会有彩虹
我国的自然保护区	我国的自然保护地体戏	保护地体系是什么	我国的自然保护区体系是什么
香蕉的	生长周期是一年半吗	生长周期是十八个月吗	香蕉的生长周期是多长时间
长津路的近亲	长颈鹿的	近亲	长颈鹿的近亲是什么
可以吃樱桃吗	二狗子不能吃呀	啊	小狗能吃吗	小狗能吃樱桃吗
一天法定节假日	给我把一年的节假日	把把阴阳的假日给我找出来	把一天把一年的找出来	法定节假日	一年有哪些法定节假日
作者如何暴瘦十分十斤	作者如何爆裂暴兽十分	暴瘦十斤？	坐着如何暴瘦十斤
蛇的寿命是多少	动物	眼镜蛇	它的寿命是多少	眼镜蛇的寿命是多少
肚子好难受是什么引起的	我吐了之后喝酸奶会有什么	我吐了之后应该喝酸奶吗	应该喝什么	孩子的肚子不消化是不是吃饱撑的	我吐的时候什么	应该喝什么呀	吐了之后应该喝什么
党会在哪里召开	导航到七街二中在哪里召开	党的七届二中全会	党的七届二中全会在哪里召开
海华第一高的	山是什么山	海拔第一高的	海拔第一高的山是什么山
百合杜甫是一个朝代的吗	李白和杜甫	李白和杜甫是一个朝代的吗
楚希环境	熊猫的	出行环境	熊猫的出行环境是什么
身份证丢了有办法查	找不到了想查询有没有驾驶本可以吗	如何查询有没有驾驶本	身份证丢了怎么查驾驶本
牛奶牛奶和梨子可以一起吃吗	牛奶	和荔枝可以一起吃	荔枝	牛奶和荔枝可以一起吃吗
宋朝的开国皇帝是谁	南宋呢	开国皇帝是谁	南宋的开国皇帝是谁
两线平行的	证明两条	证明公式	证明两条线平行的公式
光速每秒钟几千米	光有多快	音速	音速有多快
圆心角的杜甫越大梵行是不是也越大	圆心角的杜甫越大	度数越大扇形是不是也越大	圆心角的度数越大扇形是不是也越大
山坞是植物还是动物	珊瑚是什么	是植物还是动物	珊瑚是植物还是动物
大神们一般生活在哪里	大熊猫	为什么生活喜欢生活在山区	为什么的什么什么生活在山区	大熊猫为什么喜欢	大熊猫为什么喜欢生活在山区
边城的作者	体裁是什么	编程的体裁	边城的体裁是什么
我发现防止的大多和什么有关	反犬旁	什么	大多和什么有关	反犬旁大多和什么有关
一九八零年哪些城市和孙正义同辈	一九八零年	一九八零年	经济特区	一九八零年哪个城市被设为经济特区
基数词怎样变成	怎样变成序数词	基数词怎样变成序数词
四川广安的邮政编码是多少	蓬安	四川蓬安的邮政编码是多少
什么是东南亚国家的楼梯	什么是联合体	什么是东南亚的两个	什么是东南亚国家的联合体
世界上有没有蜘蛛家	有没有世界上	蜘蛛侠蜘蛛侠	世界上有没有蜘蛛侠
唐山多少集	唐三	唐山市多少级的神	唐三是多少级的神
酒驾是什么后果	那要不要坐牢	就嫁会不会坐牢	酒驾	酒驾会不会坐牢
唐山的第九分店	唐三的地求婚记	唐山的第九魂技	唐三的第九魂技是什么
禁忌女孩里面的马诺	女孩是讲什么的	禁忌女孩	是讲什么的	禁忌女孩是讲什么的
长方形的周长等于什么	长方形的	面积等于什么	长方形的面积等于什么
那个播螺怎么催熟啊	阳光催熟	菠萝	菠萝怎么催熟
我国已先后将什么总新精神活物	我国心怡物质定为毒品	新精神活性物质	我国已先后将什么新精神活性物质定为毒品
非洲有多少国家	克罗迪瓦	科洛迪瓦是哪个	是哪个国家	科洛迪瓦是哪个国家
袁隆平世纪	炎龙迷失记忆	事迹	袁隆平的事迹有哪些
小狗狗	打全麻会有影响吗	会对狗狗身体有什么影响吗	给小狗打全麻会对身体有影响吗
嗯的近义词是透气还是不透气	水利闷的很的闷	MEND近义词是什么	MEN的近义词是	闷的的	MEND近义词是什么	闷的近义词是什么
红楼梦家族	姓氏	四大家族姓氏	红楼梦四大家族的姓氏是什么
春分有什么习俗	立春呢	立春	有什么习俗	立春有什么习俗
泥鳅吃什么东西	你就吃什么虫子	吃蚯蚓吗	泥鳅吃蚯蚓吗
脖子上带的那个圈叫什么	哪吒脖子上的	哪吒脖子上的圈叫什么
调伦是不是复合材料	涤纶是不是	涤纶是不是复合材料
人身体里有胃酸吗	人的身体里面有胃酸吗	可以杀死过虫吗	人身体里的胃酸可以杀虫吗
网球难不难	技巧难不难	网球巧	打广州有哪些技巧	打网球有哪些技巧
还有哪些动物是	对人们有利	还有	还有哪些是对人们有利的	有哪些动物是对人们有利的
红心火龙果和白心火龙果是怎么回事	有什么区别	红心火龙果和白心火龙果有什么区别
葡萄的除了和葡萄一起用还可以用什么疫情	葡萄的萄除了和葡萄一起用	桃子的组词	葡萄的萄还可以怎么组词
佐罗左家匕首枪还是强	比手枪的伤害高吗	左轮手枪	左轮手枪	左轮手枪的	伤害高吗	左轮手枪的伤害高吗
猪的性格特点	属鸡的人有什么	性格特点手机的	属鸡的	鸡的特点	鸡的性格	属鸡的人的性格特点是什么
含有雌性激素的	食物	雌性激素	吃什么可以增加	吃什么食物可以增加雌性激素
大类会影响电压不稳定吗	有影响	打雷会影响吗	打雷会影响电压不稳定吗
八仙过海偶一聚是什么	八仙过海	俗语后一句	八仙过海俗语的后一句是什么
传说里面有哪些人物	MY传说之下中	里面有哪些人物	传说之下里有哪些人物
尿布湿尿尿是怎么回事	尿布湿尿尿	为什么不会湿	尿布湿尿尿为什么不会湿
樱桃的性凉还是性热	小布温热水果	荔枝呢	荔枝属于	荔枝属于性凉还是性热的
红色加蓝色等于什么颜色	红色加	加黄色呢	红色加黄色等于什么颜色
如何复印身份证	小米手机	小米手机如何	有什么工具可以复印身份证	小米手机有什么工具可以复印身份证
雷布朗多的大招是什么	必杀技是什么	雷布拉德死光	雷布拉德死光	雷布拉德星人有多强	雷布拉德星人的必杀技是什么
X的屏幕是什么材质	IPHONE的材质屏幕	IPHONEX二的	iphoneX的屏幕材质是什么
世界上最高的十名排行榜动物	世界上最智商最高的十	聪明的动物	世界上智商前十的动物是什么
彩豆是利用动物来传播种子的吗	动物会帮助	动物	动物会吧	蚕豆是利用什么	动物会帮助蚕豆传播种子吗
文珠怎么养护	那怎么养护	文竹需	文竹怎么养护
西虹穷可恶裤这个词语是什么	怎么写	琼库怎么写	穷苦怎么写
谁能凭毕业院校	毕业院校	袁隆平的	袁隆平的毕业院校是哪里
什么蜘蛛能养	咬人	什么蜘蛛咬人
河马的天敌是什么	鳄鱼会吃和密码	河马和被鳄鱼	鳄鱼有天敌吗	河马和鳄鱼是天敌吗
古代人民公园是哪	江苏省无锡市	怎么去小爱	胡埭人民公园	江苏省无锡市胡埭镇人民公园在哪
过山车最恐怖	哪个位置最恐怖	过山车哪个位置最恐怖
扇子那个单的拼音的大写是	扇子的一	SON	拼音怎么读	扇子的	扇子的语音	扇子的拼音怎么读
任明笔怎么识别真假	人民币	现在人民币	最新版的怎么识别真伪	最新版人民币怎么识别真伪
遇到紧急情况该怎么鸣笛	火车紧急情况	如何鸣笛	火车遇到紧急情况如何鸣笛
陈情人有几个孩子	情情人	陈景润有几个	陈景润有几个孩子
柳北的军师分别叫什么名字	刘备的真实叫什么名字	军师叫什么名字	刘备的军师叫什么名字
平移作用的关键	平尼作图的关电视确定平移的省	平移作图士官	关键的确定平尼的什么和什么	平移做图的关键是确定什么
代表中国特色的	京剧	中国特色的	代表中国特色的京剧是什么
绝育手术多少钱	我没问小猫	小猫绝育术	小猫的绝育手术要多少钱
苏A是哪个地方的牌照	苏H	SOUL	苏H	苏H	是哪个地方的后台	苏H是哪个地方的牌照
旅行社责任保险	的保险期间	保险的保险期限为多少年	旅行社责任保险的保险期限为多少年
有哪些历史故事	周树人	周树人做过哪些世界	周树人有哪些历史故事
课文围绕小艇些主要的交通工具鞋哪三点	威尼斯的小艇	围绕小艇是主要的交通工具写了哪三点	威尼斯的小艇围绕小艇是主要的交通工具写了哪三点
岳云鹏属什么的	侯宝林呢	侯宝林属什么的
还行每小时能爬多少	开心每分钟	海星美	海星每小时能	海星每小时能爬多少
那么严里头含量着什么	主要成分是什么	盐的	盐的主要成分是什么
乌鲁木有多少分	红楼梦	有多少回	红楼梦有多少回
北宋的开国时间	灭亡时间	背诵说出灭亡的	王国世界	北宋的灭亡时间是什么时候
华为的智能管家叫什么	那苹果呢	语音助手叫什么	苹果的语音助手叫什么
蔡徐坤的应援色	陈立农的英语	应援色	陈立农的应援色是什么
奥特之母是谁	破之父是谁	奥特	奥特之父是谁
数学里有个遗憾的词	数学一个孤独的成语	有一个孤独的词	数学里有个孤独的词是什么
用四G造一个句子	勇士	用世界的四字造	用世界造一个句子
简述唐朝的社会风气	列举对外友好交流的史实	列举唐朝交流有好的事实	列举唐朝对外友好交流的史实
唐三的名字怎么来的	唐僧的	唐僧的名字	唐僧的名字怎么来的
渴了的相克	可乐一搭配的东西	可乐	相克	可乐的相克是什么
如何经营	让人知道你的档口	如何经营一个D口	如何经营一个档口
世上最多蛇是哪种蛇	蟒蛇图片	最毒的是什么	世界上最毒的蛇是什么蛇
长期熬夜会死吗	常熬夜	该怎么办	长期熬夜该怎么办
少先队的标志是	含义是什么	少先队标志的含义是什么
血压高的人能吃曼谷哦吗	芒果的功效	血糖高的人能吃吗	血糖高的人可以吃芒果吗
人发生了什么	发烧的为什么会热啊	发送舌头为什么会烫	发烧舌头为什么会烫
完璧归赵的主人公	围魏救赵的呢	围魏救赵的主人公是谁
蚕的一生	和青	和蜻蜓的一生哪些相同点和不同点	蚕的一生和蜻蜓的一生哪些相同点和不同点
有多少人获得共和国勋章	钟南山爷爷在哪里获得	获得共和国勋章	钟南山爷爷在哪里获得共和国勋章
澳门那个不要说了多少年	是什么时候回归的	澳门是什么时候回归的
九月的诞生石是什么	十月是什么	使用的诞生石是什么	十月的诞生石是什么
五个月几大高原	我不要几大高原	中国有哪四大	中国有哪四大高原
原下节哦的习俗	吃元宵	正月十五的	元宵节的习俗是什么
煮水属于什么繁殖	竹	竹笋属于什么	竹笋属于什么繁殖
身在昌邑心在暗人是谁啊	身在曹营心在汉	人是谁	身在曹营心在汉呀	身在曹营心在汉的人是谁
闰年打哈唉是平年的	闰年还是平年的	说一年大还是平年的	闰年大	闰年大还是平年大
女生生理期能吃一套哦吗	能吃樱桃吗	女生生理期能吃樱桃吗
南京最大的体重	蓝鲸最大人个体	蓝鲸最大的体重是多少
十二生肖谁最冷	十二生肖	谁最冷血	十二生肖谁最冷血
世界上最小的动物	水熊虫	水熊虫脚小还是I H U R小	是最小的动物吗生物吗	水熊虫是最小的动物吗
绿檀吐对身体有害吗	绿檀贵还是黑糖贵阳	绿痰还是黑檀	最名贵的	绿檀贵还是黑檀贵
慈母手中线第二是什么	游子吟	第二句是什么	游子吟第二句是什么
石油的形成分布作用的	铁的行程	铁的行程	铁的	形成分布作用等	铁的形成分布作用是什么
打里一目哦之后多久可以吃降压药	高血压患者可不可以打疫苗	打完后吃降压药可以吗	打了疫苗之后可不可以服用	高血压患者打疫苗后可以服用降压药吗
王者荣耀中庄周的声音	台词是什么	王者荣耀中庄周的台词是什么
猫咪可以吃巧克力吗	为什么一直冲着我叫	猫咪为什么一直冲着人	猫咪为什么一直冲着人叫
运动和芹菜可以一起吃吗	芸豆	和芹菜可以一起吃吗	芸豆和芹菜可以一起吃吗
是谁发现了电流	尼古拉特斯拉	交流电	是谁发明了交油点	是谁发明了交流电
氯化镁溶液	硫酸亚铁溶液	硫酸亚铁	它的颜色	硫酸亚铁溶液的颜色是
巧克力可以和鱼米糖一起吃吗	巧克力和玉米汤可以吃吗	可以一起吃吗	巧克力和玉米汤可以一起吃吗
后生可什么	青出于蓝而什么英语单词吗	青出于蓝	下面是什么	下一句是什么	青出于蓝的下一句是什么
一杯摩卡星冰乐的热量是多少	无奶油的热量是	摩卡星冰乐无奶油的	摩卡星冰乐无奶油的热量是多少
有没有一种品种叫映日	有没有英瑞和花	品种叫映日荷花	有没有映日荷花这个品种
关于晏子的谚语	燕子低飞	我要听谚语	关于燕子的	关于燕子的谚语有哪些
空了哦存活了多长时间	恐龙	在地球上存在了多久	恐龙在地球上存在了多长时间
的皮肤癣可以吃拉吗	如果身上长癣的话可以吃	可以吃辣的吗	如果长了皮肤癣可以吃了啊吗	长了皮肤癣可以吃辣的吗
哪些动物喜欢吃桃子	桃子桃子树应该是怎么怎么怎么怎么做	应该怎么种	桃子树应该怎么种
十二岁儿童玩刀犯法吗	十二	儿童杀人犯法吗	十二岁儿童杀人犯法吗
会腐蚀玻璃吗	硫酸	硫酸腐蚀吗	硫酸会腐蚀玻璃吗
陈志里面含有哪些维生素	鲜橙里面有哪些	宣城的营养价值和功效	鲜橙的营养价值和功效
吃西瓜能提高抵抗力吗	我想提高	挑免疫力应该怎么办	我想提高免疫力应该怎么办
成龙有什么功效	吃胡萝卜	对人有什么好处	吃胡萝卜有什么功效
关于努力后得到成功的	形容因为努力所以成功了	你刚刚打断了我的话	形容鹦鹉笼里成功的歇后语	形容因为努力而成功的歇后语
旅社的哺乳动物	根本就没有绿色动力	绿色不容	如果有可以进行光合作用他就可以是绿色	有没有绿色的哺乳动物
黄叶乱动开箱技巧	搜索荒野乱斗的	开箱技巧是什么	荒野乱斗的开箱技巧是什么
点蚊香安全吗	电蚊香呢	对身体有危害吗	电蚊香对身体有危害吗
二级的BOSS怎么召唤	迷你世界二级的火山包子怎么找话	迷你世界的澳籍火山宝石	迷你世界火山	二级BOSS怎么召唤	迷你世界二级火山BOSS怎么召唤
班里有陶冶的人怎么办	可是他很得寸进尺	可是他非常得寸进尺怎么办	八里面如果有非常讨厌的人怎么办	班里有非常讨厌的人怎么办
植物大战僵尸的姜博长什么样子	坚果是什么	植物的	植物大战僵尸的浆果什么样的	植物大战僵尸的坚果长什么样子
儿童机洗厚颜吃什么最合适	百度一下喉炎吃什么最合适	儿童急性喉炎	吃什么最合适	儿童急性喉炎吃什么最合适
新片的尺寸用什么来表示	芯片技术	用什么计量单位	芯片技术用什么计量单位
打完狂犬育苗为什么会红肿	打完狂犬疫苗	能不能跑九百米	打完狂犬疫苗能不能跑九百米
哥斯拉基多拉金刚谁更强	红莲哥斯拉	红莲哥斯拉强还是集朵拉强	红莲哥斯拉强还是极端爱情	哪个哥斯拉最强	红莲哥斯拉强还是基多拉金刚强
中巴集合于安静是谁写的	诺曼底号	诺曼底号遇难记	诺曼底号遇难记是谁写的
气色好啊这个故事告诉我们一个什么道理	七色花	七色花	告诉我们一个什么道理	七色花告诉我们一个什么道理
左槽满原始形态	泽塔奥特曼	泽桃特曼原始形态	泽塔奥特曼原始形态
曹芳集的主人公是谁的儿子	百度一下草房子的主人公	是谁的儿子	草房子的主人公是谁的儿子
绿色加青色等于什么颜色	绿色	加金色等于什么颜色	绿色加金色等于什么颜色
澳大利亚被称为什么	澳大利亚	好打理呀活化石博物馆	为什么是世界活化石博物馆吗	澳大利亚为什么被称为世界活化石博物馆
桃花源记的翻译	桃花源记西太原中的意思	桃花源记记菜园中的意思	桃花源记季太原中的意思	晋太元中的	桃花源记里晋太元中的翻译
民国时期的外貌是指什么	请问	外蒙是指哪	民国时期的外蒙是指什么
过期的眼药水滴到眼睛里会怎样	沙眼用什么	用什么眼药水	沙眼用什么眼药水
告诉我非洲电池属于什么垃圾	废旧电池	废旧电池属于什么垃圾
出手的兽形近字	出售的受	零售	出售的售形近字是什么
的办公哦快递的创始人是谁	是德邦	创始人是谁	德邦快递的创始人是谁
放一共多少笔	是小鱼的鱼字	共多少笔	鱼字共多少笔
虎门销烟是	你的爸爸们香烟是什么时候	虎门销烟的	虎门销烟是什么时候
利兹和黄瓜可以一起吃吗	荔枝能不能	和黄瓜能不能一起生吃	荔枝和黄瓜可以一起吃吗
你跟面包大概多少卡路里	一个黑麦面包	大概多少卡路里	一个黑麦面包大概多少卡路里
怎样做才能防暑	怎样做才能防暑	天气太热了	要喝点什么才能结束	喝什么可以防暑
中国古剑术有哪些	中国古	古建筑有哪些	中国古建筑有哪些
宇宙有几个星球	七大行星	七大都有什么	七大行星都有什么
洁具表现出诗人怎样的心情	绝句	的表现表现诗人的	表现诗人怎样的心情	绝句表现诗人怎样的心情
村上春树是一个什么样子的人	村上春树写的文章	诗作作品里都表达了一个什么样子的世界	所描绘的世界是什么样子的	村上春树作品里表达了一个什么样子的世界
待到记得的英文缩写是什么	怪盗基德的	英文缩写	怪盗基德的英文缩写是什么
什么原理叫做鞋面	什么叫做鞋面	百度一下什么叫做鞋面	斜面原理	什么原理叫做斜面原理
ONE之年是几岁	博冠	是几岁	弱冠之年	弱冠之年是几岁
邦下面为什么是个围巾的睛	帮助的帮体下部怎么	底下为什么是个精	帮助的帮下边为什么是个巾
一个西瓜切四刀能切多少块	一个西瓜切四刀	一个西瓜切四刀有多少块	西瓜七十刀有多少块	十刀要切多少	十刀	十刀能切多少块	一个西瓜切十刀能切多少块
白蛋白和大白菜的区别	蛋白肽	蛋白肽和白单摆的区别	蛋白肽和白蛋白的区别
眼睛影响手机屏幕解锁吗	带眼戴眼镜影响手机	影响手机人脸识别解锁吗	戴眼镜影响手机人脸识别解锁吗
电脑上面哪个键是属于	截屏	电脑上面的哪个键是截屏
利兹的脂肪量	荔枝的图片	它的脂肪量	荔枝的脂肪量是多少
男的正常女的是色盲所生的女孩	男正常女色盲僧的会色盲吗	生的女孩会是色盲吗	男性正常女性色盲生的女孩会是色盲吗
黄色和红色合起来是什么颜色	红色黄色蓝色	三色合起来是什么颜色	红色黄色蓝色合起来是什么颜色
热带鱼一天喂几颗陨石	热带鱼	一天喂几颗鱼的食物	热带鱼一天喂几颗鱼食
十二个时辰代表什么时间	凌晨五六点是几	是什么时辰	凌晨五点钟是什么	凌晨五点钟是什么时辰
广西离僵尸中文	离江西多远	江西离广西公务员	多远	广西离江西有多远
长养多久就可以长大长成	蝉的成长	养多久可以长大	蝉养多久可以长大
别扭是不是容易得尿毒症	不经常憋尿	憋尿的坏处	憋尿是不是容易得尿毒症
我们人类之前有喂不啊吗	尾巴	为什么消失了呢	人类之前有尾巴吗
满族人都有哪些活动	满族人	介绍一下我们民族的	帮我介绍一下满足	我国民族里的蛮子无介绍一下	关于我国满族的介绍有哪些
这个高台湾同报素无是以什么名义发布的	告台湾同胞书是	是以谁的名义发布的	告台湾同胞书是以谁的名义发布的
啰嗦奥特曼一共有几个形态	几个形态	罗索奥特曼	罗索奥特曼一共有几个形态
还要走姿的字大多数都和什么有关	带有走之旁的字有什么	带有走之的字	带有走之	大多数含义都和什么有关	带有走之旁的字含义都和什么有关
绚丽多彩的左边是什么部首	绚丽多彩的炫的	左边是什么部首	绚丽多彩的炫左边是什么部首
兔子打球重电的来源是什么	兔子的	球虫病的原因是什么	兔子得球虫病的来源是什么
珊瑚是几月几号	三伏天	是几月几号	三伏是几月几号
另加奥特曼是谁	令迦奥特曼	是谁	令迦奥特曼是谁
要路感染喝什么水好	尿路感染	喝什么水好	尿路感染喝什么水好
依稀尚存不网就过的含义	一	一息尚存不忘救国	含义是什么	一息尚存不忘救国的含义是什么
澳大利亚的古堡是谁	国宝是什么	澳大利亚的国宝是什么
冰箱一个月大概多少度电	吸油烟机大概多少钱	一个月大概多少度电	吸油烟机一个月大概多少度电
土豆用什么反之	土豆是用	五根还是茎繁殖的	是用根还是茎繁殖的	土豆是用根还是茎繁殖的
炖猪脚多少才能玩	等猪九多久才会软	炖猪脚	炖猪脚多久可以软
金现报错误的叫法有什么	有什么	有什么金钱豹的错误	的错误叫法	金钱豹也可以叫什么	金钱豹错误的叫法是什么
唐山的出生地址	唐三的	唐山的出生地址	唐三的出生地址是哪里
肠胃炎会死吗	乌龟拉黄色的条状物会不会	乌龟拉黄色的屎是咋回事	乌龟生病了	得了肠炎会死吗	乌龟肠胃炎会死吗
青岛靠什么海	威海靠什么	靠什么海	威海靠什么海
普通哦套袋子是起什么作用的	葡萄出生	套带子是怎么起什么作用	葡萄套袋子是起什么作用的
PS图形的中心点在哪里	编辑	PS中心点在哪里	转换中心点	PS图形转换中心点在哪里
栗子有多少种类	有两种味	荔枝	荔枝需要注意什么	荔枝	种类	荔枝有多少种类
大熊猫在地球上生存了多少年	为什么称为活化石	大熊猫为什么称为活化石
北伐战争时期农民运动的中心	在哪一年我国国际上学人工合成刘树杰	在哪一年我国在国际上首次人工合成牛胰岛素结晶	北半球一年之中夜晚最长的那一天是哪天
儿媳妇有没有闪耀昂父母的权利	二十一分有没有射阳公婆的义务大概是有	儿媳妇有没有赡养公婆的的义务
描写离职的句子	荔枝长什么样	描写利兹的句子	描写荔枝的句子有哪些
小习俗	端午节小戏书	端午节	端午节小习俗有哪些
丰都进化生存帝王鳄吃什么饲料	方舟进化生存	方舟进化生存一王二吃什么饲料	方舟进化生存帝王鳄吃什么饲料
山楂搭配	山楂和什么不离去	相克搭配	山楂的相克搭配有什么
野外遇到鲨鱼怎么办	遇到野生动物怎么办	野外遇到野生动物怎么办
周几和张翰合作过吗	周杰不是周杰伦	和张翰认识吗	周杰和张翰合作过吗
钙片有危害吗	鬼片算是药物吗	算是要吗	钙片算药物吗
窃窃私语女人	窃窃私语人	拟人句	窃窃私语的拟人句有哪些
形容做事不焦急的歇后语	形容做事	拖拖拉拉的	形容的歇后语	形容做事情拖拖拉拉的歇后语
小迷糊可以喝凉的吗	凉的小米粥	凉了还可以喝吗	小米粥凉了还可以喝吗
一五的智商相当于几岁的小孩	鹦鹉	智商相当于几岁的小孩	鹦鹉的智商相当于几岁的小孩
花浇水能喝吗	花椒水	有什么作用	花椒水有什么作用
已将那表达了作者什么情感	忆江南	忆江南表达了作者什么情感
金字旁加一个	加一个童等于几	金字旁加一个童是什么字
冰粥是全国百城城市之一吗	山东省滨州市是冰	是全国百强城市之一吗	山东省滨州市是全国百强城市之一吗
连爱吃吃的有什么功效	莲藕	功效有什么	莲藕有什么功效
在野外迷路怎么班别	嗯你你嗯你嗯N N	怎么辨别	方向怎么看	在野外迷路怎么辨别方向
初五的圆的还是贬的呀	初五的有没有	月亮是圆的还是扁的还是有朝霞吗	初五的月亮是圆的还是扁的
十五夜望月中什么梦的	十五夜望月中	什么描写了中秋节	十五夜望月中什么描写了中秋节
浏览有酒精味能吃吗	榴莲吃了会醉吗	怎么选榴莲	榴莲有酒精味还能吃吗
社会主义核心价值观是什么	一个	是什么时候提出来的	社会主义核心价值观是什么时候提出来的
电焊打眼吃阿莫西林可以吗	电焊打眼如果找不着人荣辱	找不到人五	有几种解决方案	电焊打眼有几种解决方案
睡觉是冷水泡还是热水泡	水饺	水饺用冷水	水饺是冷水泡还是热水泡
在什么会议上周恩来鲜明的提出仇同存一的	求同存异的方针	嗯	在什么会议上提出了	在什么会议上周恩来提出了求同存异的方针
明码有位于哪个地方	百度一下秦始皇的兵马俑	位于哪个地方	秦始皇的兵马俑位于哪个地方
猴头菇放了两三年还能吃吗	干的猴头菇	干猴头菇	等了两三年还能吃吗	干的猴头菇放了两三年还能吃吗
怎么确认残血没死	蚕宝宝死没死	怎么确认	怎么确认死没死	怎么确认蚕虫	怎么确认蚕宝宝死没死
肯林地是怎么死的	到底是怎么死的	肯尼迪为	为何之死	肯尼迪是怎么死的
四大名关除了山海关玉门关嘉峪关还有哪个关	那你明光里面没有玉门关吗	关里面没有玉门关吗	四大名关里有没有玉门关
睡衣掉到地下怎么办	声音调到地下怎么办	是水银	水银掉在地上怎么办
怎么快速的去景点	衣服静电	裙子	怎么处理	怎么快速去掉衣服上的静电
重度抑郁症杀人犯	我问你一个法律问题	患者杀人犯不犯法	重度抑郁症的患者杀人犯不犯法
人体体温低烧是多少度	三十五度多是	三十五度是什么	三十五度是低烧吗
手机钢化膜和水凝膜的好	性别	哪一种保护手机更好	手机钢化膜和水凝膜哪一种保护更好
介绍一下中国古代台阶的由来	太监的	说一下由来	中国古代太监的由来
八仙过海的下一句是什么	前人栽树	它的下一句是什么	前人栽树的下一句是什么
图都绿了有什么害处	吃的土豆	吃的土豆绿色的	土豆绿了有什么害处
割草时闻到的在干什么	植物盖干什么	青草气味是植物在干什么	割草时闻到的青草气味是植物在干什么
七十五和九十的工艺书有哪些	七十五	和九十的公因数	七十五和九十的公因数有哪些
凿壁借光故事是	它的主人公是谁	凿壁借光的主人公是谁
抽样无害的危害	什么叫做臭氧污染	影响是什么	臭氧污染的危害是什么
贡山当是多少年成立的	你在哪多少年成立的	共产党是	是今年成立吗	共产党是在哪年成立的
生病了能吃果断	是果冻	生病了能吃吗	生病了能吃果冻吗
五A数据线可以配十八	五A	五A充电器可以	可以用十八瓦充电器吗	五A数据线可以用十八瓦充电器吗
臣子啊嗯的生平经历	陈子昂	他的生平经历	陈子昂的生平经历
少先队是谁创立的	领导者是谁	少先队的领导者是谁
俄罗斯的话语	俄罗斯	苏联是用用用	分裂后产生哪两个国家	苏联分裂后产生哪两个国家
有鲨鱼吗	太平洋	太平洋的大海有吗	太平洋的大海有鲨鱼吗
鹤壁有音信吗	银杏树	银杏树长什么样	鹤壁哪里有	鹤壁哪里有银杏树
火线和导火线是什么颜色	火色	火线和零线	火线和零线是什么颜色
稀有里的是什么题材	西游记是	西游记是什么	是什么体裁	西游记是什么体裁
补办需要什么资料	身份证丢失	丢失去补办需要什么资料	身份证丢失去补办需要什么资料
舒尔特方格有什么	舒尔特方格有什么优点吗	玩法有哪些	舒尔特方格有哪些玩法
马来西亚著名的景点	吉隆和	马来西亚著名的诗集	著名的事迹	马来西亚著名的事迹有哪些
我的世界	这个是什么游戏	我的世界是什么游戏
大雄吗的生活习性	大熊猫的	生活习性你知道有哪些吗	大熊猫的生活习性有哪些
如果没有以上这些东西该怎么办	仓鼠	木屑要放多少	仓鼠的木屑要放多少
如何变得更优秀	怎么样才能让自己	更加勤奋	怎么样才能让自己更加勤奋
可乐放冰箱冻起来吗	放在冰箱里会爆炸吗	可乐放在冰箱里冻起来会爆炸吗
下雨前蜘蛛为什么	没打完人家	蜘蛛逃到哪里去了	下雨前蜘蛛逃到哪里去了	为什么逃啊	下雨前蜘蛛为什么要逃
血腥标是由什么构成	血红细胞	是由什么组成的	血红细胞是由什么组成的
母的蚊子为什么比较大	为什么吸血	母蚊子为什么吸血
天理赛马是个什么样的故事	田忌赛马是历史上有名的故事吗	田忌赛马	是个怎样的故事	田忌赛马是个怎样的故事
紫色石蕊溶液遇碱变什么色	紫色石蕊溶液	与酸性变什么色	遇酸变什么色	紫色石蕊溶液遇酸变什么色
按压的主要气候类型	南亚的	南亚的主要	南亚的主要气候类型是什么
北半球白天最长的一天是什么	白天最短的一天是几	北半球白天	北半球白天最短的一天是哪天
O型血是否很少见	是不是熊猫血	世上最少见的最罕见的血型是什么	什么是熊猫血	O型血是否罕见	O型血是否是熊猫血
抑郁症喝什么	抑郁症	喝什么药	抑郁症应该喝什么药
三十九的因数	三十九跟五十二的	跟五十二的公因数	三十九跟五十二的公因数是什么
闰年	咱们算是哪天	怎样算	怎么算闰年是哪天
涉笔高利贷高利贷	我一年百分之百的利息犯法吗	讲	年利率达到多少就犯法了	高利贷的年利率达到多少是犯法的
世界上第十一高峰的建制	这世界上第十一高的	建筑	世界上第十一高的建筑是哪个
故宫的修建过程	跟故宫安有	有关的故事	和故宫有关的	和故宫有关的小故事有哪些
龙眼跟荔枝的肉为什么那么像	吃荔枝为什么会上火	跟龙眼的区别	荔枝跟龙眼的区别是什么
西北庞帝主要有哪些作物	西北盆地是	有什么作用	西北盆地的主要作用有哪些
胆在身体的哪个部位	关在哪个部位	肝在哪个	肝在身体的哪个部位
砌墙的记得同音字	砌墙的砌的	砌墙的砌的	相近字是什么	砌墙的砌的相近字是什么
别把树怎么不结果呀	琵琶树	琵琶树不结	不结果子是怎么回事儿	枇杷树不结果是怎么回事
肥猪肉的短骨纯喊小爱同学	白肉虎猪肉白肉的含胆固醇	胆固醇含量多少	猪肉的胆固醇含量是多少
熊哦的主要分布的	熊猫的	主要分布地	熊猫的主要分布地是哪里
海南最好是棕熊	最好的中学	海南最好的中学是什么
盗窃判多少年	赌博	判多少年	赌博判多少年
水合规会产生什么化学反应	水和硅	水和硅会产生什么化学反应
怎么重复利用	玻璃瓶	重复利用	重新使用玻璃瓶	菠萝	重新使用的方法	玻璃瓶怎样重复利用
中国少儿先锋队入怎么写月	申请申请书的申请书	婶的	申请书的申请书	中国少儿先锋队入队申请书怎么写
大海里的海马	用比喻句怎么说	海绵用比鱼怎么写	大海里的海马	海马用比喻句怎么写
北京故宫是国家什么	是几级	是国家几级旅游景区	北京故宫是国家几级旅游景区
社会主义在中国为什么	为什么成功	为什么只有中国走这个成功了	为什么中国走社会主义制度成功了
破折号的写法是	破折号的	作用是啥	破折号的作用是什么
整体认读音节怎么	应该怎么写	整体认读音节怎么写
罗隐比白居易大吗	顾况比白居易大吗	司空图呢	司空图比白居易大吗
俄国唯一的航母	德国唯一恒	二战期间的	二战期间德国	航母叫什么名字	二战期间德国唯一的航母叫什么
王肥皂可以洗脸吗	但不要经常用	硫磺肥皂可以吗	可以洗脸吗	硫磺肥皂可以用来洗脸吗
合成橡胶是合成材料吗	经	合金属于吗	合金属于合成材料吗
历史上有多少荒地	是皇帝	历史上一共有多少位	历史上一共有多少位皇帝
李白和黄渤是同一朝的吗	李白和王博士	和王勃是同一朝代吗	李白和王勃是同一朝代吗
碰鼻是哪国的见面礼	泡面你是哪国的见面礼仪	贴面礼	贴面礼是哪国的见面礼仪
假如给我三天光明一书中海伦最不喜欢的艺名	海龙最不喜欢的一门功课是	假如给我三天光明中海伦最不喜欢的一门功课是什么
关男的属什么运动队	郭艾伦的蜀黍运动队	冠伦	郭艾伦	所属运动队	郭艾伦的所属运动队是哪个
能吃面包吗	早晨能吃吗	早晨可以	可以空腹吃吗	早晨可以空腹吃面包吗
林戴宇的人物特点	林黛玉的人口	人物性格	林黛玉的人物特点是什么
螳螂会不会飞	他吃什么	螳螂	螳螂吃什么
尤其如何洗净	衣服上蹭上怎么办	蹭上油漆	衣服蹭上油漆如何清洗
氧气吗不关会不会有事	氧气泵	可以一天到晚开吗	氧气泵可以一直开着吗
张仲景的作品	李时珍呢	作品有什么	李时珍的作品有什么
数羊的	属蛇人性格	数羊人呢	是什么性格	属羊的人是什么性格
可以吃榴莲吗	嗯帮我看一下高血压可以可以吃	高血压可以吃榴莲吗
南瓜和窝瓜一样	兰花不过我有区别吗	有什么区别	南瓜和窝瓜有什么区别
哈密瓜皮能擦鞋吗	西瓜	香蕉皮可以吗	香蕉皮可以擦鞋吗
WEAR胶怎么去除在线上	五零二胶	五零二	怎样去除	五零二胶怎样去除
四川的四海在哪	死海在哪个地方	四川有没有	四川的死海在哪个位置
两个月的宝宝每天喂D应该吃多少	婴儿每天	应该每天吃多少单位的维生素D	婴儿应该每天吃多少单位的维生素D
取一杯天上的水往证明月下一句	取一杯天上的水	青衣为天上的水是哪首歌唱的	取一杯天上的水是哪首歌唱的
四字词	四字四字词	四只雌的的拟声词	四字词的你生有	四字词的拟声词有哪些
扎完针灸以后半个小时就可以	可以洗澡吗	扎完针灸以后能吗	针灸后能洗澡吗
维生素D怎样补	吃什么补维生素D	牛奶中有吗	牛奶中有维生素D吗
主要的传输协议是什么	因特网	因特网主要的传输协议是什么
狗的的温碧要多久才能好	温碧	懂得的	定要多久才能好	好	狗得了瘟病	狗得了瘟病要多久才能好
香蕉挂在糕点保质期会更高吗	香蕉	挂在树上保质期会更长吗	香蕉挂在树上保质期会更长吗
讲一下金九是什么意思	金秋	这个词怎么讲	金秋这个词是什么意思
猫能吃橘子吗	我可以吃什么水果	猫可以吃什么	猫可以吃什么水果
小龙虾应该怎么养	小龙虾适合在什么的	用什么水养的最好	小龙虾用什么水养的最好
荔枝大多住址在哪里	李之	历史大多种植在哪	荔枝大多种植在哪里
目前所发掘的哪个朝代贵族	墓葬规模最大	规模最大等级最高结构最为复杂	目前所发掘的哪个朝代贵族墓葬规模最大
四川省属于盆地吗	四川盆地吗	中国有几个	中国有几个盆地
一二应该是一线城市	你说了个三亚他跟我搜救三亚是几	那是几线城市	三亚是几线城市
商朝第一位皇帝是谁	生态祖是谁	周朝皇帝是谁	第一位是谁	周朝第一位皇帝是谁
塘东儿的儿子是谁	唐山	唐三的	唐山生了几个孩子	唐三的孩子是谁
三分之一大于还是小于	三分之一大雨零点三	大于还是小于零点三	三分之一大于还是小于零点三
蚕会不会变	查会不会变成飞蛾	返回会不会变成飞蛾	蚕会不会变成飞蛾
榆树不能少于谁	ISSUE不能小于谁	余数	余数不能小于谁
小番茄属于	要叫圣女果对肝脏	王I防皱卧小番茄	性凉还是性热	小番茄性凉还是性热
头发太油怎么办	分叉怎么办	头发分叉怎么办
香菇和牛肉能一起吃吗	西兰花和牛肉呢	能一起吃吗	西兰花和牛肉能一起吃吗
小苏打的化学符号	碳酸氢钠	它的化学分子式	碳酸氢钠的化学分子式是什么
基因突变的随机性与不定性其中一个吗	金图片的随机性与不定向性是同一个吗	基因突变的	基因突变的随机性与不定向性是同一个吗
去樱桃核弹	快速去的办法	去樱桃子的	快速去樱桃核的办法
你能不能和开水一起用	吃梨的时候能不能喝	梨能不能和开水一起吃
蒲公英的本领是什么	蒲公英的	如懿是靠风来传播的	蒲公英是	生存的本领是什么	蒲公英生存的本领是什么
军队里师长大还是	秦队里军长大还是	军队里师长大还是	军队里师长大还是军长大
陀螺鸟能跑多快	鸵鸟是什么样的	能跑多快呀	鸵鸟能跑多快
氯化镁与花甲	氯化镁	氯化钾	化学式是什么	氯化镁和氯化钾的化学式是什么
元素周期表第51位是什么	第52位是什么	元素周期表第52位是什么
中子星的密度有多大	最大的密度	什么物体的最大	什么物体的密度最大
毛泽东在哪一年	论持久战是毛泽东在哪	长篇演讲于哪一年	论持久战是毛泽东在哪一年的演讲
为什么平年和闰年的天数不一样呢	谁知道九九八八	是平年还是闰年	一九九八年	一九九八年是平年还是闰年
用英语介绍长城	用英语介绍资金城	介绍紫禁城	怎样用英语介绍紫禁城
叉子要洗吗	百度一下方便面的叉子	需要清洗吗	方便面的叉子需要清洗吗
泥鳅没有水会死吗	泥鳅绑架放生在河里他会死吗	泥鳅该怎么放松	泥鳅该怎么放生
广东是属于什么	属于亚热带还是亚热带还是热带	广东属于亚热带还是热带
陈文力学主要内容二十字左右	程门立雪	主要内容	程门立雪主要内容是什么
别团对人的症状是什么	对呀	低血糖	有什么反应	低血糖的症状有哪些
接种疫苗以后什么事项	注意事项	接种疫苗后的	接种疫苗后的注意事项有哪些
为什么裙带菜	裙带菜可以省着	可以生吃吗	裙带菜可以生吃吗
首都的独自怎么写	首都的独自	手段	首都的都	读字笔顺怎么写	笔顺怎么写	首都的都字笔顺怎么写
奥特曼的视频是怎么录出来的	收到没有奥特曼	变身器有哪些	奥特曼的变身器有哪些
新冠病毒的宿主是谁	请问	蝙蝠携带吗	蝙蝠携带新冠病毒吗
霉霉	煤气的煤的	能做成什么	煤气的煤能做成什么
残机鉴定标准	残疾	鉴定标准	残疾鉴定标准是什么
图像的格式可以相互转换吗	什么	PS中的默认格式	ps中的图像格式可以相互转换吗
在水里泡多久会坏	我泡的是莲藕不是西瓜	我说莲藕泡多久	莲藕在水里泡多久会坏
什么蛇没有毒在热带雨林里	蟒蛇呢	蟒蛇有吗	看不见的有毒吗	蟒蛇有毒吗
不小心把别人拉进了怎么退出去呢	拉进黑名单	如果把别人拉进的自己都还有那要怎么办	不小心把别人拉进了黑名单怎么办
买到假货如何维权	麦当劳	网上买到	网上买到假货如何维权
普通矿泉水一般都	矿泉水	高多少厘米	普通矿泉水高多少厘米
眼睛无人草丛生的汉字	野径无人打一字	眼睛无人草童声	野径无人草童声	野径无人草丛生打一字
喝中药的时候可以喝绿豆汤吗	没有科学依据	可以喝牛奶吗	喝中药的时候可以喝牛奶吗
多好的冰块放在冷藏里绘画吗	动物好的冰块	已经冰冻好的冰块	放在冷藏里会化吗	已经冰冻好的冰块放在冷藏里会化吗
USE一个月能挣多少钱	幼师	幼师	一个月能赚多少钱	幼师一个月能赚多少钱
生日了该送什么礼物	男朋友生日了	男朋友生日了	该送什么生日礼物	男朋友生日送什么礼物
冰心的原名	著作有哪些	代表作	冰心	冰心的代表作有哪些
将下列俗语补充完整前人栽	人情前人栽树	后面是什么	俗语前人栽树后面是什么
发霉的花生会不会致癌	吃饭吃花生酱最重矮呢	会致癌吗	吃花生酱会致癌吗
火山的	火山	火山的	火山的位置	是如何形成的	火山是如何形成的
二分之根号二的九次等于多少	二的九次方等于多少	根号二的十次等于多少	根号十次	根号二的十次是多少	十次幂是多少	根号二的十次幂是多少
怎样有效预防湿疹	用白醋洗脚没	使用白醋洗澡能去吗	使用白醋洗澡能去湿疹吗
太阳系里有哪些恒星有哪些行星	今天是如何围绕恒星运转的	行星运转的	行星是如何围绕恒星运转的
怎么求圆的	怎么求	怎么求周长	怎么求圆的周长
二四零是多大的脚	二四零是多大的鞋码	四十个码是多长	四十的鞋码	是多长	四十的鞋码长度是多少
梅花有什么	梅花是什	有什么品质	梅花有什么品质
我国的第三任主席是谁	第四任是谁	中国的第四任是谁	中国的第四任主席是谁
诸葛亮是不是三国演义里面的	诸葛	有什么名言	诸葛亮有什么名言
金鱼有没有乳房	鲸鱼	有没有乳房	鲸鱼有没有乳房
多大宝宝可以吃橙子	陈子	好处有哪些	宝宝吃橙子的好处有哪些
刘备是三国演义里面的人物吗	司马懿是	是三国演义里面的人物吗	司马懿是三国演义里面的人物吗
二月份有几天	平年二月份有多少天	平年	闰年有多少天	闰年二月份有多少天
哟喂饼的喝什么茶最好	忧郁为	有胃病的人喝什么	有胃病的人喝什么茶好
先天下之忧而忧后天下之乐而乐是什么意思	是谁	这句是谁说的	先天下之忧而忧后天下之乐而乐是谁说的
职高跟中专哪个好	那职高呢	是学什么的	职高是学什么的
为什么井驻颜不能泡澡	景柱	请蛀牙	颈椎炎	可以泡澡吗	颈椎炎可以泡澡吗
馒头的热量高吗	那豆浆高吗	豆浆的热量高吗
鸡蛋和玉米可以同时补吗	我问你的是可以同时煮吗	可以放在一起同时煮吗	鸡蛋和玉米可以放在一起同时煮吗
海洋占地球表面积的多少	陆地战	陆地表面的多少	陆地占地球表面积的多少
英国的国宝是什么	美国的	国宝是什么	美国的国宝是什么
小爱夏枯草	夏枯草是什么	功效是什么	夏枯草的功效是什么
捐的花园作者是谁	巨人的花园	作者是谁	巨人的花园作者是谁
顺的市花是什么	沈阳抚顺的	市花是什么	沈阳抚顺的市花是什么
求救信号是什么	国际海难	国际海难求就行号是什么	国际海难求救信号是什么
电解两化的化学方程式	氧化铝的	电解氧化铝的化学方程式是什么
陕宁选自哪本书	闪灵的	出处是哪	闪灵选自哪本书
哪个英雄克制	EIEI	克制凯	哪个英雄克制凯
离职一般被称为什么	荔枝	荔枝一般	一般被称为什么	荔枝一般被称为什么
牛和鲨鱼谁的牙齿更硬	人和	大鱼	人和鲨鱼	和鲨鱼谁的牙齿更硬	人和鲨鱼谁的牙齿更硬
手上有舞灵二怎么弄掉	浇水	我零二	胶水五零二怎么弄	粘手上怎么弄掉	胶水五零二粘手上怎么弄掉
十年一共有多少	秒	一共有多少秒	十年一共有多少秒
看迪迦奥特曼大战的地方在哪一个国家	诞生	我要看迪迦奥特曼战神的国家	诞生的地方	迪迦奥特曼诞生的地方是哪里
什么加什么等于	加什么等于白色	什么加什么色	什么加什么等于白色
奶酪怎么做的	奶油的	需要什么材料	做奶油需要什么材料
雏菊的花语是什么	玫瑰花呢	花语是什么	玫瑰花的花语是什么
水滴的第一次换成言字旁	水	换成言字旁是什么字	水滴的滴字换成言字旁是什么字
为什么动物细胞	不适合	为什么	不适合用来制作细胞膜	为什么动物细胞不适合用来制作细胞膜
日本是多久废除	废除天皇制	日本是多久废除天皇制的
凡士林可以磨腿吗	可以抹伤口吗	凡士林可以抹伤口吗
骆驼祥子中虎妞的性格特点	我的箱子装虎妞	最终的结局是什么	骆驼祥子中虎妞最终的结局是什么
混凝土是水泥吗	就是	混凝土和粘的价格一样吗	混凝土和水泥的价格一样吗
龙尔哈市是怎么逝世的	清太祖努尔哈赤	被安葬在哪	清太祖努尔哈赤被安葬在哪
查明花的花语	查梅花的	我要听茶梅花的	我要听CHA R MING的花语	茶梅的花语是什么
嗯诗人杜甫在绝境里描写了什么什么什么什么四个数词	诗人杜甫在绝句里描写了	绝句里描写了几个数词	诗人杜甫在绝句里描写了几个数词
方舟你睡的六不一会	防溺水的	六不一会是什么	防溺水的六不一会是什么
蛋挞需要多久	烤蛋挞	需要多少度多长时间	烤蛋挞需要多少度多长时间
中国二元酸有哪些	十大元帅	中国十大	中国十大元帅有哪些
万里长城至今有多少年	万里长城	是什么时候建好的	万里长城是什么时候建好的
地震是哪一年发生的	那他没听见	唐山大地震	唐山大地震是哪一年发生的
陶渊明是什么先生	五柳先生	王安石是什么	王安石是什么先生
迎春花是什么颜色	梨花是什么	梨花是什么颜色
木棉树又叫啥	木棉树叫什么树	有什么象征	木棉树有什么象征
迪迦奥特曼是在哪里出生的	迪迦	迪迦奥特曼是在哪里出现的	是从什么时候出现的	迪迦奥特曼是从什么时候出现的
百香果的热量	白雪	百香果的营养成分表	含糖量是多少	百香果的含糖量是多少
除了变色龙之外还有什么动物是魂传说	最擅长伪装术	除了变色龙之外还有什么动物擅长伪装
最高段位是什么	王者荣耀最高	王者荣耀的	王者荣耀的最高段位是什么
宋亚轩是双鱼座吗	双鱼座的咽炎	演员有哪些	是双鱼座的	双鱼座的演员有哪些
两点和自然点有什么区别	燃点	燃点	和自燃点有什么区别	燃点和自燃点有什么区别
婴儿起口水疹怎么办	嗯	我擦拭以后存上了破皮之后口水疹再留下来	多插几次互粉	应该用什么药	婴儿起口水疹应该用什么药
哪些虫子对人类	你先哪是益虫哪些害虫	异虫有	异虫有多少个	哪些虫子是益虫
嘴道理卡注销一次该怎么办	嘴巴里	嘴巴里卡住小一次该怎么办	小鱼刺该	嘴巴里卡住小鱼刺该怎么办
茉莉花什么时候换	几年换一次盆	茉莉花	茉莉	什么时候换盆	茉莉花什么时候换盆
鬼叫交通的优点	轨道交通的	优点是什么	轨道交通的优点是什么
美国的首都是谁	那英国呢	英国的首都是哪里
请问农历二奥特曼的人间体被谁打了	请问	尤莉安被谁	人间体被谁打了	尤莉安人间体被谁打了
白面是什么做的	面粉是什么做的	热量是多少	面粉的热量是多少
刀片可以上分级吗	可以托运吗	刀片可以吗	可以飞机托运吗	刀片可以飞机托运吗
台湾的台湾地区的	台湾的	台湾的歌手	我是问台湾的	四大天王	是哪几位歌手	台湾的四大天王是哪几位歌手
似分之四和二分之一哪个大	四分之四盒	四分之四还是	四分之四	和二分之一哪个大	四分之四和二分之一哪个大
大珠小珠落玉盘所形容的弹奏声小小小猪小布小布	所形容的是什么乐器的他都不听我说完呀	所形容的是什么乐器的弹奏声	大珠小珠落玉盘所形容的是什么乐器的弹奏声
夏至后面	下一个节气是什么	夏至后下一个节气是什么
丁程鑫的应援色	送阿轩呢	宋亚轩的	宋亚轩的应援色是什么
小爱小爱世界草的花语是什么	小爱小爱四叶草的	花语是什么呀	四叶草的花语是什么
琵琶里面的果子有什么作用	枇杷里面的	的核有什么作用	枇杷的核有什么作用
怎么追	阳光大男孩	性格阳光的男孩怎么追
狗怎么	学狗叫吗	狗怎么炒的	狗怎么叫的
围城是谁写的	钱钟书的老婆是谁	活了多少岁	杨绛活了多少岁
给同桌的	给同桌冤家的流	离别赠言	给同桌的离别赠言
医保是什么时候有的	内蒙	几年开始有的	内蒙的医保是哪年开始有的
一字千金是谁的故事	帮我搜索一字千金是谁的故事	一诺千金呢	一诺千金是谁的故事
那个葫芦娃里边哪个是	哪个是千里眼呀	葫芦娃里面哪个是千里眼
在哪里可以买到	明目地黄丸	哪里有卖的	在哪里可以买到明目地黄丸
人间喜剧这本小说是谁创作的	高老头呢	高老头这本小说是谁创作的
小孩子长期玩水晶泥会不会	小朋友长期万岁晶泥对手对皮肤	有没有影响	小孩子长期玩水晶泥会不会对皮肤有影响
十一的饮食	因数	十一的因数
清朝的公主	公主要裹小脚吗	清朝的公主裹小脚吗
世界有哪七大奇迹	世界	十大奇迹有哪些	世界十大奇迹有哪些
我说爱国卫生的画怎么画	还有那个五星红旗	还有那个新红旗的话	五星红旗怎么画
达芬奇介绍一下	psk?s281985i0	最后的晚餐呢	达芬奇最后的晚餐简介
怎么做胶水	怎么做胶水	怎么做可以做	起泡椒	怎么做起泡胶的胶水
自足是动物还是昆虫	蜘蛛	蜘蛛是动物还是昆虫
初代哥斯拉是什么样的	哥斯拉有多高	金刚有多少	金刚有多高
中华人民共和国成立的	中华人民共和国	几月几日成立的	中华人民共和国是几月几日成立的
容易出虚汗什么情况	怕热什么情况	怕热出虚汗是什么情况
公证处的业务范围	民事诉讼与公正	民事诉讼与公正的犬联系	简答题	简答民事诉讼与公证的联系
跆拳道	空手道区别	跆拳道和空手道的	跆拳道与空手道的区别
怎么把花做成	可以晒干	干花	怎么把花做成干花
康熙皇帝的儿子是谁	太子是谁	康熙皇帝立的太子是谁
甘拉稀是什么东西	垃圾分类	电池属于什么	电池属于什么垃圾
四分四分之七	四分之七	化成小数是啥	四分之七化成小数是什么
政府机关办事要提高透明度	政府	这	透明是什么意思	政府机关办事要提高透明度中的透明是什么意思
失调之国在哪里	在哪里	音乐之都呢	音乐之都在哪里
男子二十岁左右的年纪	豆蔻年华	二十岁左右的年纪指什么	男子二十岁	叫什么之年	男子二十岁的年纪被称为什么之年
中国少年先锋	几月几日	先锋队	在什么时候建立的	中国少年先锋队在几月几日建立的
距离的公式	公式怎么说	重力	重力的公式怎么写
一个西瓜切四刀最多	一个西瓜切四刀	最多能切多少块	一个西瓜切四刀最多能切多少块
许人之长下一句	取人之长下一句	精诚所至呢	精诚所至下一句
小米之家能维修吗	手机出问题了	小米之家能剪修吗	小米之家能维修手机吗
全国一共有多少人啊	中国和	和外国一共有多少人口	全世界总人口数是多少
绝句唐杜甫两个黄鹂鸣翠柳一行白鹭上青天窗含西岭千秋雪门泊东吴万里船	绝句这首诗	这里有四种颜色都是哪四种颜色	绝句描写的四种颜色都是哪四种颜色
生育之后生育险有没有补贴呀	有生育险然后	有生育险然后生孩子	有没有补贴	怎么补贴法在上海	在上海生完孩子之后	在上海生育险有没有补贴
小孩子困了怎么办	我儿子困了	嗯怎么能精神一点	小孩子困了怎么能精神一点
西红西红柿的	西红柿的营养价值	可以治疗哪几种疾病	西红柿可以治疗哪几种疾病
描写人热门外贸	葫芦描写人类外貌	描写人	三个词语	描写人外貌的三个词语
电脑怎么设置	视频桌面	怎么应用视频桌面	设置视频桌面	电脑怎么设置视频桌面
优师笔试和面试	幼师笔试和面试	又是笔试和面试难吗	优势	有时要考哪些证	幼师要考哪些证
党的建设的	党的根本当	根本方针是	党的建设的根本方针是什么
犀牛的角有什么作用呢	有什么药用价值	犀牛的角有什么药用价值
小油条的重量是多少	一个小油桃多少	重量是什么	一个小油桃的重量是多少
联合国生物多样性大会	联合国生物多样会	会标	联合国生物多样性大会的会标是什么
加菲猫可以吃	加菲猫能不能吃	能吃蜂蜜吗	加菲猫可以吃蜂蜜吗
燃放的燃的形近字	放的行进字	贩卖的贩	贩卖的贩的形近字有哪些
中国大饥荒在	挨饿的时候哪一年	中国大饥荒在哪一年
新冠疫苗可以打吗	新冠疫苗	新冠一秒	体质不好能打吗	新冠疫苗体质不好能打吗
上洗头发好不好	晚上洗好不好	晚上洗头发好不好
十二生肖怎么怎么	六虎	生效怎么排的	十二生肖怎么排序的
刚刚打完疫苗以后	老人洗完澡可以	打完	老人刚刚打完针以后可以洗澡吗	老人刚打完疫苗可以洗澡吗
医保卡可以报销	做手术吗	医保卡可以报销做手术吗
有关冰心的资料	嫁给谁了	冰心嫁给谁了
圆明园	圆明园	圆明园关于名人的故事	圆明园	圆明园的故事	怎么被毁的	圆明园是怎么被毁的
科莫多巨蜥天敌是什么	跟我说句C要卖多少钱	科莫多巨蜥	科莫多巨蜥能卖多少钱
七分之十九化成整数	化成带分数或整数	七分之十九化成整数或者带分数是多少
可乐的热量	白开水的呢	白开水的热量是多少
恐龙时代有鸭嘴龙吗	爱德蒙托龙呢	世界上存在吗	恐龙时代有爱德蒙托龙吗
杜甫诗的特点	陆游呢	陆游诗的特点
我国奥运会第一枚金牌	我国奥运会	金牌设计者	我国奥运会第一枚金牌是由谁设计
端午节还有几天	午节是什么日子	关五节什么日子	端午节什么日子	有哪些习俗	端午节有哪些习俗
月球能不能测	勉强能不能测质量	月球	月球能不能测质量
十五岁可以用什么词来表示	古人	古人女子	用什么词来形容	古人女子十五岁古人用什么词来形容
椰子汁有什么功效	有没有营养	椰子汁有营养吗
网易云如何显示	歌词如何	如何移到桌面	网易云如何将歌词移到桌面
Q:世界最寒冷的地点	最热的	世界上最热的地方是哪里
小孩能不能吃坚果	能不能吃	燕窝小	小孩能不能吃燕窝
洗衣机的功率是多少瓦	抽油烟机的	功率	抽油烟机的功率是多少瓦
格式化了怎么找回	U盘里的	以后把你的内容被格式化了怎么找回	U盘的内	U盘的内容被格式化了怎么找回
每天可以变成什么字新字	美丽的美	美丽的美可以变成什么新字
派大星经典语录有哪些	派大星的经典语录	章鱼哥的呢	章鱼哥的经典语录有哪些
生肖羊和什么星座最匹配	和属什么的最匹配	属羊的和什么属相最匹配
成都和重庆对比	GDP谁高	成都和重庆的GDP谁高
缅甸的首都是	老挝的呢	老挝的首都是哪里
汗国是什么国	有没有韩国这个名字	三国演义里面有没有	三国演义里有没有韩国
美式的西红柿怎么念	西红柿的美式英语怎么说	这是英文怎么说西红柿的	美式的	美式英语的西红柿怎么说	英式英语的西红柿怎么说	英语发音有几种啊	西红柿英式英语的发音有几种
次微格是哪个国家的作者	代表小说	刺猬呃的代表小说	次微格的代表小说
貔貅有几只脚	一休有没有翅膀	貔貅	貔貅有没有翅膀
俄罗斯的首都	来几首都	埃及	埃及的首都在哪
英国物理学家	酷我金锁与英国物理学家	史蒂芬霍金属于	史蒂芬霍金属于英国物理学家吗
蚂蚁咬到会不会有毒	背黑色飞马一咬了	黑色飞蚂蚁	被黑色飞蚂蚁咬到有没有毒
被蚂蚁咬后	被蚂蚁咬然后他明明是生产一个小泡泡的嗯	为什么会肿起来	被蚂蚁咬后为什么会肿起来
高山流水的主人公	把灯一庄的主人公	老当益壮的呢	老当益壮的主人公是谁
我说律师不是厨师	律师的最高中暑是什么	是的最高证书是什么	律师的最高证书是什么
中国的别称	英国的呢	英国的别称是什么
化学反应中冰凡什么作用	明矾	明矾促进杂志沉降	化学体重明矾	化学中明矾的作用
而山到术师的作者是什么	十二纬路不准见君	山回路转不见君雪上空留马行处	作者是谁	山回路转不见君雪上空留马行处的作者是谁
为爱表现在全身的什么地方	胃癌	全身哪个症状能表现肺癌的症状	为爱表现在身上的症状	胃癌表现在身上有哪些症状
买四送一可以视为打几折	买一送一可以视为打金枝	是打几折	买一送一是打几折
长颈鹿停下来会不会死去	长颈鹿趴下会不会死	长颈鹿趴下会不会死	什么情况下会死掉	什么情况下长颈鹿会死
啤酒的热量	白酒的人	热量	白酒的热量是多少
白纸讲个高念什么	白白的字	白字加一个	加个告别的告念什么	白字加个告别的告念什么
的人物性格	宋江的人物性格	鲁智深的呢	鲁智深的人物性格是什么
金字塔是死咯的一种吗	我说的是金字塔	是石塔的一种吗	金字塔是石塔的一种吗
美国人口居世界第几位	美国二零	二零一二年居世界人口第	美国二零一二年居世界人口第几位
地球上氮气含量是多少	大气中	氮气的含量是多少	大气中氮气的含量是多少
演员张凯丽是哪年生人	张凯丽的出生地是哪	身高是多少	演员张凯丽的身高是多少
气候是不是中国文化遗产	世界文化遗产	西湖是不是	西湖是不是世界文化遗产
肌肉重还是	有种	鸡肉重还是脂肪咒	肌肉重还是脂肪重
买中药在哪里去买	在哪里去买	网上在哪里去买	网上买中药在哪里买
紫外线能不能促进植物生长	能不能促进西瓜生长	紫外线能不能促进西瓜生长
的最大公因数	三十五个七十	三十五和七十五的	三十五和七十五的最大公因数是什么
吃冰糕好不好	对怀孕好不好	怀孕了吃好不好	怀孕了吃冰糕好不好
北京均价是多少	北京市	新房	新房均价是多少	北京新房均价是多少
氟化氢的化学式	与二氧化硅的反应方程式	氟化氢与二氧化硅的反应方程式
为什么在几千年的时间里一直没有出现比他更高	的建筑	比金字塔更高的建筑	为什么几千年里没出现过比金字塔更高的建筑
字母N加一	字母N家	加一笔是什么	字母N加一笔是什么
第二次世界大战的发动者有谁	第一次世界大战有谁	第一次世界大战发动者有谁
乌龟可以在水里养吗	乌龟乌龟有一八吗	乌龟有一八吗	乌龟有一百八吗	有尾巴吗	乌龟有尾巴吗
水母会放电吗	海绵宝宝里怎么会放电	海绵宝宝里还	水母会放电吗	海绵宝宝中水母会放电吗
打完星光疫苗可以吃泡面吗	打新冠疫苗	可以吃泡面吗	打新冠疫苗可以吃泡面吗
女中代表有哪些	女中音	女中音代表有哪些
国歌的名字又叫什么	我想知道国歌的	歌的中心思想能告诉我吗	国歌的中心思想是什么
墨汁粘在衣服上怎么吃呢	若汁粘在衣服上怎么吃呢	怎么清理	墨汁粘在衣服上该怎么清理
尼罗河的长度有多少	亚马逊	亚马逊河的长度是多少
无常是谁写的	无常无常	五伦五常四维八德	五伦五常四维八德是谁写的
肝胆科之父是谁	原子弹	原子弹之父是谁
说一下黄瓜的	黄瓜的营养成分	小爱黄瓜里的上学校	黄万里的膳食纤维有多少	黄瓜里的膳食纤维有多少
保全费可以由败诉方承担吗	财产保全费	财产保全费可以由败诉方承担吗
关于林冲与他相关的故事情节有什么	林冲放大什么	棒打什么	林冲棒打什么
如何用奶茶粉	简单	如何用奶茶粉简单制作奶茶	如何用冰淇淋粉做	如何用冰淇淋粉做奶茶
植物的什么部位队	生长素	什么部位队生长素最敏感	植物的什么部位对生长素最敏感
离石属于阴性水果还是阳性的	你是寒性水果吗	梨	梨是寒性水果吗
吃完芒果可以吃西红柿吗	可以吃臭豆腐吗	吃完芒果可以吃臭豆腐吗
嫦娥四号探测器在我国	什么城市发射的	嫦娥四号探测器在我国的什么城市发射的
劝劝的拼音劝告的劝	劝告的劝怎么写	小爱同学串的大写字母是什么犬	劝告的劝大写字母是什么
豆芽的热量	给我播的热量	胡萝卜	胡萝卜的热量是多少
金钱树一次性需要蒸多少	一次浇水多少毫升	金钱树	金钱树一次浇水多少毫升
新区的脸谱中的黑色代表什么	京剧中的	黑色表示什么	京剧中的黑色脸谱表示什么
拔河菠萝	马可波罗	到中国的时候中国是什么朝代	马可波罗到中国的时候中国是什么朝代
木耳的热量	木耳的功效可以减肥吗	有哪些烹饪方法	木耳有哪些烹饪方法
肱骨三角肌粗隆	在哪里	肱骨三角肌	肱骨三角肌在哪里
购买二手房评估怎么做	你	二手房评估费用	评估需要评估几次呢	二手房评估需要评估几次
恻隐之心仁之端演的意思	恻隐之心仁之端演的警察	恻隐之心仁之端也	恻隐之心仁之端也的意思
汤姆索亚是谁写的	马克吐温是美国的吗	马克吐温有什么作品	语言特点是什么	马克吐温的语言特点是什么
胃不好的话有哪些食物不能吃	胃溃疡不能吃什么	能吃龙虾吗	胃溃疡能吃龙虾吗
什么鲸鱼会在头上	那他叫什么名字呢	可以从头上喷出水他叫什么名字呢	可以从头上喷出水的鲸鱼叫什么名字
幸运颜色是什么	射手座的	射手座的幸运颜色是什么
全国抗战八路军新四军和华南人民抗日游击队	全国抗战	消灭日军多少人	全国抗战消灭日军多少人
仓鼠可以吃巧克力吗	可以吃人的食物吗	仓鼠可以吃人的食物吗
钢铁是怎样炼成的	钢铁是怎样炼成的书	百度	内容概括	钢铁是怎样炼成的内容概括
NASA的地理位置	西藏拉萨得力文具	西藏拉萨	西藏拉萨的地理位置
要打狂犬病疫苗吗	狂犬病疫苗	狂犬病	狂犬病有潜伏期吗	狂犬病潜伏期要打疫苗吗
知了C松树的营养吗	我说资料	吸收树的营养吗	知了吸收树的营养吗
春节和元宵节哪个过得最快	春节和元宵节	哪个先过	春节和元宵节哪个先过
请行者是谁	潜行者	漫威中的	漫威中的浅行者是谁
悬梁刺骨的人物是谁	手不释卷的呢	手不释卷的人物是谁
背圆周率背到第一百位	你能背圆周率背到小数点后的第一百位吗	你能背到小数点圆周率小数点后第几位	圆周率你能背到小数点后第几位	小数点后第九位是什么	圆周率的小数点后第九位是什么
用诗句描写	狂舞的地方	荒芜的地方	荒芜的地方用诗句怎么描写
王昭君后来去了哪个族	王昭君的丈夫是谁	是哪个民族	王昭君的丈夫是哪个民族
放SHE中黄色代表什么	藏戏中	绿色代表什么	藏戏中绿色代表什么
什么蛇是黑色的	黑色的蛇的图片	外表是黑色的里面是白色的	什么蛇外表是黑色的里面是白色的
石家庄是哪个省的	河北	河北和北京	和北京的关系	河北和北京的关系是什么
谭维之地塔一字	弹丸之地	打一字	弹丸之地打一字
氯化氨的相对原子质量	打开小爱实验室	氯化钠的呢	氯化钠的相对原子质量
沙漠中从梨沙走出来之后要干什么	流沙	出来后要干什么	沙漠中从流沙中出来后要干什么
休克是多少	储存量	出血量达到多少可以出现	出血量达到多少可以出现休克
安徽省现任	安徽现在存档	现任省长是谁	安徽省现任省长是谁
叶鼎之面是什么意思	灭顶之灭	灭顶之灾面是什么意思	灭顶之灾的灭是什么意思
偷学亮是谁	头悬梁	悬梁刺骨	古人	悬梁刺股的古人是谁
螳螂有毒吗	螳螂有毒吗	青蛙有吗	青蛙有毒吗
紫薯含糖量高不高	吃紫薯有什么好处	有什么不好之处	吃紫薯有什么不好之处
吃胶原蛋白可不可以预防摔了	衰老不是摔肿	是不是可以预防衰老衰老	吃胶原蛋白可以预防衰老吗
天行健君子以什么	天行健	天行健君子以自强不息	出自哪里	天行健君子以自强不息出自哪里
小燕子每年春天从什么	小燕子每年春天	美女每年春天从什么方向飞到	小燕子每年春天从什么方向飞
最苦与最乐作者	最苦与最乐选自	选自哪本书	最苦与最乐选自哪本书
咳嗽喝什么药好	感冒咳嗽喝什么药好	止咳糖浆管用吗	感冒咳嗽喝止咳糖浆管用吗
世说新语言语是哪朝代的	世说新语言语的	作者是谁	世说新语言语的作者是谁
一九五五年与中国建交的国家或地区	王	地区主要分布在	一九五五年与中国建交的国家或地区主要分布在哪里
可以给狗吃	可以可以给狗吃咖啡因吗	吃巧克力呢	可以给狗吃巧克力吗
找脱光是出自谁的苦学苦学故事	凿壁偷光	凿壁偷光是出自谁的苦学故事
鸡蛋的还是小鸡	鸡蛋仔还是小鸡仔	鸡蛋走还是小鸡	鸡蛋枣还是小七	鸡蛋枣还是小鸡早	你出生的早还是羁绊出生的早	小鸡出生的早	是小鸡出生的早还是鸡蛋出生的早
袁隆平去世为什么	袁隆平去世的时候是	去世的时候有几岁	袁隆平去世的时候是多少岁
来月经可以抽什么	来月经可以	可以抽血吗	来月经可以抽血吗
咬合力最强的动物前十排行	想和你第二长的是谁	我刚刚说什么	咬合力最	第二大的动物是谁	咬合力第二大的动物是谁
貔貅是龙的孩子	第几个孩子	貔貅是龙的第几个孩子
瞳孔的颜色	重播的颜色会变吗	瞳孔	瞳孔的颜色会变吗
为什么圆规指挥还原呀	画圆	为什么圆规能画圆
发工资的银行卡	银行卡必须是本人过	银行卡必须是本人	银行卡必须是本人的	银行卡必须的才能领工资吗	发工资的银行卡必须是本人才能领取吗
哦哪些国定假节日	高速	上高数能免费	哪些国定节假日上高速能免费
喝酒有多大年纪	何炅是哪里人	和酒有多大年纪	何炅有多大年纪
台湾还有两种叫法是什么	台湾还有两种叫法	台湾在元朝叫什么	在清朝时叫什么	台湾在清朝时叫什么
红楼梦哪个故事里面有个三字	那三国演义呢	哪个故事有三字	三国演义哪个故事里面有三字
老挝的首都	缅甸	缅甸的呢	缅甸的首都是哪里
无糖可乐喝了	菱塘哦小爱同学	百度一下名堂可乐喝了会长胖吗	无糖可乐喝了会长胖吗
葫芦不长液怎么办	葫芦我光长杆部长	湖光长干不长叶子怎么办	葫芦光长杆不长叶怎么办
表示舍身取义	辽师舍身取义的诗句	表示舍身取义的	表示舍身取义的诗句
袁隆平的妻子动辄活着吗	袁隆平老爷爷的妻子现在还活着吗	现在居住在什么地方	袁隆平的妻子现在居住在什么地方
薄荷有什么功效	柠檬有什么好处	加薄荷有什么功效	柠檬加薄荷有什么功效
狗为什么喜欢摇紫襟	狗为什么喜欢王子君	玩纸巾	狗为什么喜欢玩纸巾
罗马的国花是什么	美国	美国的是什么	美国的国花是什么
女童身高标准	十四二岁女童身高	十二岁女童	十二岁女童身高标准
安徒生童话里面有什么	安徒生的代表作有	皇帝的新装是	安徒生童话里有皇帝的新装吗	安徒生	安徒生童话有什么支撑	皇帝的新装是安徒生的代表作吗
身上起睡都能不能洗澡	出水痘快要好了能不能	身上起水痘快要好了	起水痘快好了能不能洗澡
设塘HE是什么意思	血糖仪	数值HE是什么意思	血糖仪数值HE是什么意思
山东省临清市	山东省临清市的皖源有多大	山青省	山东省	山东省临清市宛园	山东省临清市宛园有多大
王者荣耀的凯有什么皮肤	王者的花木兰	有什么皮肤	王者荣耀的花木兰有什么皮肤
怎样做眼部按摩	眼部按摩视频	眼部按摩视频	影片	韩信	防止近视	怎样做眼部按摩可以防止近视
